absolutise: absolutize
absolutised: absolutized
absolutises: absolutizes
absolutising: absolutizing
accessorise: accessorize
accessorised: accessorized
accessorises: accessorizes
accessorising: accessorizing
acclimatisation: acclimatization
acclimatise: acclimatize
acclimatised: acclimatized
acclimatises: acclimatizes
acclimatising: acclimatizing
actualisation: actualization;
actualise: actualize
actualised: actualized
actualises: actualizes
actualising: actualizing
aeroplane: airplane
aeroplanes: airplanes
aggrandise: aggrandize
aggrandised: aggrandized
aggrandisement: aggrandizement
aggrandises: aggrandizes
aggrandising: aggrandizing
agonise: agonize
agonised: agonized
agonises: agonizes
agonising: agonizing
agonisingly: agonizingly
alphabetisation: alphabetization
alphabetise: alphabetize
alphabetised: alphabetized
alphabetises: alphabetizes
alphabetising: alphabetizing
aluminium: aluminum
amortisable: amortizable
amortisation: amortization
amortise: amortize
amortised: amortized
amortises: amortizes
amortising: amortizing
analogue: analog
analogues: analogs
analyse: analyze
analysed: analyzed
analyser: analyzer
analysers: analyzers
analyses: analyzes
analysing: analyzing
anglicisation: anglicization
anglicisations: anglicizations
anglicise: anglicize
anglicised: anglicized
anglicises: anglicizes
anglicising: anglicizing
anonymisation: anonymization
anonymise: anonymize
anonymised: anonymized
anonymiser: anonymizer
anonymisers: anonymizers
anonymises: anonymizes
anonymising: anonymizing
antagonise: antagonize
antagonised: antagonized
antagonises: antagonizes
antagonising: antagonizing
anthropomorphisation: anthropomorphization
anthropomorphise: anthropomorphize
anthropomorphised: anthropomorphized
anthropomorphises: anthropomorphizes
anthropomorphising: anthropomorphizing
anticlockwise: anticlockwize
apologise: apologize
apologised: apologized
apologises: apologizes
apologising: apologizing
appetiser: appetizer
appetisers: appetizers
armour: armor
armoured: armored
armourer: armorer
armourers: armorers
armours: armors
armoury: armory
artefact: artifact
artefacts: artifacts
authorisation: authorization
authorisations: authorizations
authorise: authorize
authorised: authorized
authorises: authorizes
authorising: authorizing
baptise: baptize
baptised: baptized
baptises: baptizes
baptising: baptizing
behaviour: behavior
behavioural: behavioral
behaviourism: behaviorism
behaviourist: behaviorist
behaviourists: behaviorists
behaviours: behaviors
bobsleigh: bobsled
bobsleighs: bobsleds
brutalisation: brutalization
brutalise: brutalize
brutalised: brutalized
brutalises: brutalizes
brutalising: brutalizing
camomile: chamomile
cancelled: canceled
cancelling: canceling
cannibalisation: cannibalization
cannibalise: cannibalize
cannibalised: cannibalized
cannibalises: cannibalizes
cannibalising: cannibalizing
canonicalised: canonicalized
canonisation: canonization
canonisations: canonizations
canonise: canonize
canonised: canonized
canonises: canonizes
canonising: canonizing
capitalisation: capitalization
capitalise: capitalize
capitalised: capitalized
capitalises: capitalizes
capitalising: capitalizing
castor: caster
castors: casters
catalogue: catalog
catalogues: catalogs
categorisable: categorizable
categorisation: categorization
categorisations: categorizations
categorise: categorize
categorised: categorized
categorises: categorizes
categorising: categorizing
centenaries: centennials
centenary: centennial
centilitre: centiliter
centilitres: centiliters
centimetre: centimeter
centimetres: centimeters
centralisation: centralization
centralisations: centralizations
centralise: centralize
centralised: centralized
centralises: centralizes
centralising: centralizing
centre: center
centres: centers
cerebella: cerebellums
characterisation: characterization
characterisations: characterizations
characterise: characterize
characterised: characterized
characterises: characterizes
characterising: characterizing
cheque: check
cheques: checks
circularise: circularize
circularised: circularized
circularises: circularizes
circularising: circularizing
civilisation: civilization
civilisations: civilizations
civilise: civilize
civilised: civilized
civilises: civilizes
civilising: civilizing
clamour: clamor
clamours: clamors
cochleae: cochleas
colonisation: colonization
colonise: colonize
colonised: colonized
coloniser: colonizer
colonisers: colonizers
colonises: colonizes
colonising: colonizing
colorisation: colorization
colorise: colorize
colorised: colorized
colorises: colorizes
colorising: colorizing
colour: color
coloured: colored
colourful: colorful
colourfully: colorfully
colourfulness: colorfulness
colouring: coloring
colourings: colorings
colourizer: colorizer
colourizers: colorizers
colours: colors
commercialisation: commercialization
commercialise: commercialize
commercialised: commercialized
commercialises: commercializes
commercialising: commercializing
compartmentalisation: compartmentalization
compartmentalise: compartmentalize
compartmentalised: compartmentalized
compartmentalises: compartmentalizes
compartmentalising: compartmentalizing
computerisation: computerization
computerise: computerize
computerised: computerized
computerises: computerizes
computerising: computerizing
conceptualisation: conceptualization
conceptualisations: conceptualizations
conceptualise: conceptualize
conceptualised: conceptualized
conceptualises: conceptualizes
conceptualising: conceptualizing
contextualisation: contextualization
contextualise: contextualize
contextualised: contextualized
contextualises: contextualizes
contextualising: contextualizing
cornflour: cornflor
cosy: cozy
councillor: councilor
councillors: councilors
councillorship: councilorship
counselling: counseling
counsellor: counselor
counsellors: counselors
criminalise: criminalize
criminalised: criminalized
criminalises: criminalizes
criminalising: criminalizing
criticise: criticize
criticised: criticized
criticises: criticizes
criticising: criticizing
crystallisation: crystallization
crystallise: crystallize
crystallised: crystallized
crystallises: crystallizes
crystallising: crystallizing
customisable: customizable
customisation: customization
customisations: customizations
customise: customize
customised: customized
customiser: customizer
customisers: customizers
customises: customizes
customising: customizing
daemonisation: daemonization
daemonise: daemonize
daemonised: daemonized
daemonises: daemonizes
daemonising: daemonizing
decentralisation: decentralization
decentralise: decentralize
decentralised: decentralized
decentralises: decentralizes
decentralising: decentralizing
decilitre: deciliter
decilitres: deciliters
decriminalisation: decriminalization
decriminalise: decriminalize
decriminalised: decriminalized
decriminalises: decriminalizes
decriminalising: decriminalizing
defence: defense
defences: defenses
dehumanisation: dehumanization
dehumanise: dehumanize
dehumanised: dehumanized
dehumanises: dehumanizes
dehumanising: dehumanizing
deinitialise: deinitialize
deinitialised: deinitialized
deinitialises: deinitializes
deinitialising: deinitializing
demarshalling: demarshaling
dematerialisation: dematerialization
dematerialise: dematerialize
dematerialised: dematerialized
dematerialises: dematerializes
dematerialising: dematerializing
demilitarisation: demilitarization
demilitarisations: demilitarizations
demilitarise: demilitarize
demilitarised: demilitarized
demilitarises: demilitarizes
demilitarising: demilitarizing
demobilisation: demobilization
demobilise: demobilize
demobilised: demobilized
demobilises: demobilizes
demobilising: demobilizing
democratisation: democratization
democratise: democratize
democratised: democratized
democratises: democratizes
democratising: democratizing
demonise: demonize
demonised: demonized
demonises: demonizes
demonising: demonizing
demoralisation: demoralization
demoralise: demoralize
demoralised: demoralized
demoralises: demoralizes
demoralising: demoralizing
denormalised: denormalized
dependant: dependent
dependants: dependents
depersonalise: depersonalize
depersonalised: depersonalized
depersonalises: depersonalizes
depersonalising: depersonalizing
deputise: deputize
deputised: deputized
deputises: deputizes
deputising: deputizing
desensitisation: desensitization
desensitise: desensitize
desensitised: desensitized
desensitises: desensitizes
desensitising: desensitizing
deserialisability: deserializability
deserialisable: deserializable
deserialisation: deserialization
deserialisations: deserializations
deserialise: deserialize
deserialised: deserialized
deserialiser: deserializer
deserialisers: deserializers
deserialises: deserializes
deserialising: deserializing
destabilisation: destabilization
destabilise: destabilize
destabilised: destabilized
destabilises: destabilizes
destabilising: destabilizing
desynchronisation: desynchronization
desynchronisations: desynchronizations
desynchronise: desynchronize
desynchronised: desynchronized
desynchronises: desynchronizes
desynchronising: desynchronizing
devirtualisation: devirtualization
devirtualise: devirtualize
devirtualised: devirtualized
devirtualises: devirtualizes
devirtualising: devirtualizing
dialled: dialed
dialling: dialing
digitalisation: digitalization
digitalise: digitalize
digitalised: digitalized
digitalises: digitalizes
digitalising: digitalizing
digitisation: digitization
digitise: digitize
digitised: digitized
digitises: digitizes
digitising: digitizing
disorganisation: disorganization
disorganised: disorganized
dramatisation: dramatization
dramatisations: dramatizations
dramatise: dramatize
dramatised: dramatized
dramatises: dramatizes
dramatising: dramatizing
draughtsman: draftsman
draughtsmanship: draftsmanship
draughtsmen: draftsmen
duelled: dueled
duelling: dueling
economise: economize
economised: economized
economises: economizes
economising: economizing
editorialise: editorialize
editorialised: editorialized
editorialises: editorializes
editorialising: editorializing
empathise: empathize
empathised: empathized
empathises: empathizes
empathising: empathizing
emphasise: emphasize
emphasised: emphasized
emphasises: emphasizes
emphasising: emphasizing
emporia: emporiums
endeavour: endeavor
endeavours: endeavors
energise: energize
energised: energized
energises: energizes
energising: energizing
epitomise: epitomize
epitomised: epitomized
epitomises: epitomizes
epitomising: epitomizing
equalisation: equalization
equalise: equalize
equalised: equalized
equaliser: equalizer
equalisers: equalizers
equalises: equalizes
equalising: equalizing
eulogise: eulogize
eulogised: eulogized
eulogises: eulogizes
eulogising: eulogizing
evangelisation: evangelization
evangelise: evangelize
evangelised: evangelized
evangelises: evangelizes
evangelising: evangelizing
externalise: externalize
externalised: externalized
externalises: externalizes
externalising: externalizing
familiarisation: familiarization
familiarisations: familiarizations
familiarise: familiarize
familiarised: familiarized
familiarises: familiarizes
familiarising: familiarizing
fantasise: fantasize
fantasised: fantasized
fantasises: fantasizes
fantasising: fantasizing
favour: favor
favourable: favorable
favourably: favorably
favoured: favored
favouring: favoring
favourite: favorite
favourites: favorites
favouritism: favoritism
favours: favors
fertilisation: fertilization
fertilise: fertilize
fertilised: fertilized
fertiliser: fertilizer
fertilisers: fertilizers
fertilises: fertilizes
fertilising: fertilizing
fervour: fervor
fillet: filet
fillets: filets
finalisation: finalization
finalise: finalize
finalised: finalized
finalises: finalizes
finalising: finalizing
fiscalisation: fiscalization
fiscalisations: fiscalizations
fiscalised: fiscalized
flavour: flavor
flavoured: flavored
flavouring: flavoring
flavours: flavors
flexitime: flextime
formalise: formalize
formalised: formalized
formalises: formalizes
formalising: formalizing
fraternisation: fraternization
fraternise: fraternize
fraternised: fraternized
fraternises: fraternizes
fraternising: fraternizing
fulfil: fulfill
fulfilment: fulfillment
fulfils: fulfills
galvanise: galvanize
galvanised: galvanized
galvanises: galvanizes
galvanising: galvanizing
generalisation: generalization
generalisations: generalizations
generalise: generalize
generalised: generalized
generalises: generalizes
generalising: generalizing
glamorise: glamorize
glamorised: glamorized
glamorises: glamorizes
glamorising: glamorizing
glamour: glamor
globalisation: globalization
globalise: globalize
globalised: globalized
globalises: globalizes
globalising: globalizing
grey: gray
greyed: grayed
greying: graying
greyish: grayish
greylist: graylist
greylisted: graylisted
greylisting: graylisting
greylists: graylists
greyness: grayness
greys: grays
greyscale: grayscale
harbour: harbor
harboured: harbored
harbouring: harboring
harbours: harbors
harmonisation: harmonization
harmonisations: harmonizations
harmonise: harmonize
harmonised: harmonized
harmonises: harmonizes
harmonising: harmonizing
homogenisation: homogenization
homogenise: homogenize
homogenised: homogenized
homogenises: homogenizes
homogenising: homogenizing
honour: honor
honourable: honorable
honourables: honorables
honourary: honorary
honoured: honored
honouring: honoring
honours: honors
hospitalisation: hospitalization
hospitalisations: hospitalizations
hospitalise: hospitalize
hospitalised: hospitalized
hospitalises: hospitalizes
hospitalising: hospitalizing
humanisation: humanization
humanise: humanize
humanised: humanized
humanises: humanizes
humanising: humanizing
humour: humor
humourless: humorless
humourous: humorous
humours: humors
hybridisation: hybridization
hybridise: hybridize
hybridised: hybridized
hybridises: hybridizes
hybridising: hybridizing
hypnotise: hypnotize
hypnotised: hypnotized
hypnotises: hypnotizes
hypnotising: hypnotizing
hypothesise: hypothesize
hypothesised: hypothesized
hypothesises: hypothesizes
hypothesising: hypothesizing
idealisation: idealization
idealise: idealize
idealised: idealized
idealises: idealizes
idealising: idealizing
idolise: idolize
idolised: idolized
idolises: idolizes
idolising: idolizing
immobilisation: immobilization
immobilise: immobilize
immobilised: immobilized
immobiliser: immobilizer
immobilisers: immobilizers
immobilises: immobilizes
immobilising: immobilizing
immortalise: immortalize
immortalised: immortalized
immortalises: immortalizes
immortalising: immortalizing
immunisation: immunization
immunisations: immunizations
immunise: immunize
immunised: immunized
immunises: immunizes
immunising: immunizing
individualise: individualize
individualised: individualized
individualises: individualizes
individualising: individualizing
industrialisation: industrialization
industrialise: industrialize
industrialised: industrialized
industrialises: industrializes
industrialising: industrializing
initialisable: initializable
initialisation: initialization
initialisations: initializations
initialise: initialize
initialised: initialized
initialiser: initializer
initialisers: initializers
initialises: initializes
initialising: initializing
institutionalise: institutionalize
institutionalised: institutionalized
institutionalises: institutionalizes
institutionalising: institutionalizing
internalisation: internalization
internalise: internalize
internalised: internalized
internalises: internalizes
internalising: internalizing
internationalisation: internationalization
internationalise: internationalize
internationalised: internationalized
internationalises: internationalizes
internationalising: internationalizing
ionisation: ionization
ionise: ionize
ionised: ionized
ionises: ionizes
ionising: ionizing
italicise: italicize
italicised: italicized
italicises: italicizes
italicising: italicizing
itemise: itemize
itemised: itemized
itemises: itemizes
itemising: itemizing
jeopardise: jeopardize
jeopardised: jeopardized
jeopardises: jeopardizes
jeopardising: jeopardizing
jeweller: jeweler
jewellery: jewellry
journalling: journaling
judgement: judgment
kilometre: kilometer
kilometres: kilometers
labellable: labelable
labelled: labeled
labeller: labeler
labellers: labelers
labelling: labeling
labour: labor
laboured: labored
labouring: laboring
labours: labors
legalisation: legalization
legalise: legalize
legalised: legalized
legalises: legalizes
legalising: legalizing
legitimise: legitimize
legitimised: legitimized
legitimises: legitimizes
legitimising: legitimizing
lemmatisation: lemmatization
lemmatise: lemmatize
lemmatised: lemmatized
lemmatises: lemmatizes
lemmatising: lemmatizing
levelled: leveled
levelling: leveling
liberalise: liberalize
liberalised: liberalized
liberalises: liberalizes
liberalising: liberalizing
licence: license
licences: licenses
linearisation: linearization
linearisations: linearizations
linearise: linearize
linearised: linearized
linearises: linearizes
linearising: linearizing
litre: liter
litres: liters
localisation: localization
localisations: localizations
localise: localize
localised: localized
localiser: localizer
localisers: localizers
localises: localizes
localising: localizing
manoeuvrability: maneuverability
manoeuvrable: maneuverable
manoeuvre: maneuver
manoeuvred: maneuvered
manoeuvres: maneuvers
manoeuvring: maneuvering
marginalise: marginalize
marginalised: marginalized
marginalises: marginalizes
marginalising: marginalizing
marshall: marshal
marshalled: marshaled
marshaller: marshaler
marshallers: marshalers
marshalling: marshaling
marshalls: marshals
marvellous: marvelous
materialise: materialize
materialised: materialized
materialises: materializes
materialising: materializing
maximisation: maximization
maximise: maximize
maximised: maximized
maximises: maximizes
maximising: maximizing
mechanisation: mechanization
mechanise: mechanize
mechanised: mechanized
mechanises: mechanizes
mechanising: mechanizing
memorialise: memorialize
memorialised: memorialized
memorialises: memorializes
memorialising: memorializing
memorisation: memorization
memorise: memorize
memorised: memorized
memorises: memorizes
memorising: memorizing
mesmerise: mesmerize
mesmerised: mesmerized
mesmerises: mesmerizes
mesmerising: mesmerizing
metabolise: metabolize
metabolised: metabolized
metabolises: metabolizes
metabolising: metabolizing
metastasise: metastasize
metastasised: metastasized
metastasises: metastasizes
metastasising: metastasizing
metre: meter
metres: meters
micrometre: micrometer
micrometres: micrometers
militarised: militarized
millilitre: milliliter
millilitres: milliliters
millimetre: millimeter
millimetres: millimeters
minimisation: minimization
minimise: minimize
minimised: minimized
minimises: minimizes
minimising: minimizing
mischaracterisation: mischaracterization
mischaracterise: mischaracterize
mischaracterised: mischaracterized
mischaracterises: mischaracterizes
mischaracterising: mischaracterizing
misspelt: misspeled
mitre: miter
mitres: miters
mobilisation: mobilization
mobilisations: mobilizations
mobilise: mobilize
mobilised: mobilized
mobilises: mobilizes
mobilising: mobilizing
modelled: modeled
modelling: modeling
modernisation: modernization
modernisations: modernizations
modernise: modernize
modernised: modernized
modernises: modernizes
modernising: modernizing
modularisation: modularization
modularise: modularize
modularised: modularized
modularises: modularizes
modularising: modularizing
moisturise: moisturize
moisturised: moisturized
moisturiser: moisturizer
moisturisers: moisturizers
moisturises: moisturizes
moisturising: moisturizing
monopolisation: monopolization
monopolise: monopolize
monopolised: monopolized
monopolises: monopolizes
monopolising: monopolizing
moralise: moralize
moralised: moralized
moralises: moralizes
moralising: moralizing
mould: mold
moulded: molded
moulder: molder
mouldered: moldered
mouldering: moldering
moulders: molders
moulding: molding
mouldings: moldings
moulds: molds
mutualisation: mutualization
mutualise: mutualize
mutualised: mutualized
mutualises: mutualizes
mutualising: mutualizing
nanometre: nanometer
nanometres: nanometers
nasalisation: nasalization
nasalisations: nasalizations
nasalise: nasalize
nasalised: nasalized
nasalises: nasalizes
nasalising: nasalizing
nationalisation: nationalization
nationalise: nationalize
nationalised: nationalized
nationalises: nationalizes
nationalising: nationalizing
naturalisation: naturalization
naturalise: naturalize
naturalised: naturalized
naturalises: naturalizes
naturalising: naturalizing
neighbour: neighbor
neighboured: neighbored
neighbourhood: neighborhood
neighbourhoods: neighborhoods
neighbouring: neighboring
neighbours: neighbors
neutralisation: neutralization
neutralise: neutralize
neutralised: neutralized
neutralises: neutralizes
neutralising: neutralizing
normalisable: normalizable
normalisation: normalization
normalisations: normalizations
normalise: normalize
normalised: normalized
normaliser: normalizer
normalisers: normalizers
normalises: normalizes
normalising: normalizing
odour: odor
odours: odors
optimisation: optimization
optimisations: optimizations
optimise: optimize
optimised: optimized
optimiser: optimizer
optimisers: optimizers
optimises: optimizes
optimising: optimizing
organisation: organization
organisational: organizational
organisations: organizations
organise: organize
organised: organized
organiser: organizer
organisers: organizers
organises: organizes
organising: organizing
ostracise: ostracize
ostracised: ostracized
ostracises: ostracizes
ostracising: ostracizing
overemphasise: overemphasize
overemphasised: overemphasized
overemphasises: overemphasizes
overemphasising: overemphasizing
oxidisation: oxidization
oxidise: oxidize
oxidised: oxidized
oxidises: oxidizes
oxidising: oxidizing
packetise: packetize
packetised: packetized
packetises: packetizes
packetising: packetizing
palaeolithic: paleolithic
palatalisation: palatalization
palatalise: palatalize
palatalised: palatalized
palatalises: palatalizes
palatalising: palatalizing
palletise: palletize
palletised: palletized
palletises: palletizes
palletising: palletizing
parallelisation: parallelization
parallelisations: parallelizations
parallelise: parallelize
parallelised: parallelized
parallelises: parallelizes
parallelising: parallelizing
paralyse: paralyze
paralysed: paralyzed
paralyses: paralyzes
paralysing: paralyzing
parameterisable: parameterizable
parameterisation: parameterization
parameterisations: parameterizations
parameterise: parameterize
parameterised: parameterized
parameterises: parameterizes
parameterising: parameterizing
parametrisation: parametrization
parametrisations: parametrizations
parametrise: parametrize
parametrised: parametrized
parametrises: parametrizes
parametrising: parametrizing
paravirtualisation: paravirtualization
paravirtualise: paravirtualize
paravirtualised: paravirtualized
paravirtualises: paravirtualizes
paravirtualising: paravirtualizing
parenthesise: parenthesize
parenthesised: parenthesized
parenthesises: parenthesizes
parenthesising: parenthesizing
parlour: parlor
parlours: parlors
patronise: patronize
patronised: patronized
patronises: patronizes
patronising: patronizing
penalise: penalize
penalised: penalized
penalises: penalizes
penalising: penalizing
personalisation: personalization
personalise: personalize
personalised: personalized
personalises: personalizes
personalising: personalizing
plagiarise: plagiarize
plagiarised: plagiarized
plagiarises: plagiarizes
plagiarising: plagiarizing
plough: plow
ploughed: plowed
ploughing: plowing
ploughman: plowman
ploughmen: plowmen
ploughs: plows
ploughshare: plowshare
ploughshares: plowshares
pluralisation: pluralization
pluralise: pluralize
pluralised: pluralized
pluralises: pluralizes
pluralising: pluralizing
polarisation: polarization
polarise: polarize
polarised: polarized
polariser: polarizer
polarisers: polarizers
polarises: polarizes
polarising: polarizing
politicise: politicize
politicised: politicized
politicises: politicizes
politicising: politicizing
popularisation: popularization
popularisations: popularizations
popularise: popularize
popularised: popularized
popularises: popularizes
popularising: popularizing
practise: practize
practised: practized
practises: practizes
practising: practizing
preauthorisation: preauthorization
preauthorisations: preauthorizations
preauthorise: preauthorize
preauthorised: preauthorized
preauthorises: preauthorizes
preauthorising: preauthorizing
pressurisation: pressurization
pressurise: pressurize
pressurised: pressurized
pressurises: pressurizes
pressurising: pressurizing
prioritisation: prioritization
prioritise: prioritize
prioritised: prioritized
prioritises: prioritizes
prioritising: prioritizing
privatisation: privatization
privatisations: privatizations
privatise: privatize
privatised: privatized
privatises: privatizes
privatising: privatizing
professionalise: professionalize
professionalised: professionalized
professionalises: professionalizes
professionalising: professionalizing
programme: program
programmes: programs
propagandise: propagandize
propagandised: propagandized
propagandises: propagandizes
propagandising: propagandizing
proselytise: proselytize
proselytised: proselytized
proselytiser: proselytizer
proselytisers: proselytizers
proselytises: proselytizes
proselytising: proselytizing
publicise: publicize
publicised: publicized
publicises: publicizes
publicising: publicizing
pulverise: pulverize
pulverised: pulverized
pulverises: pulverizes
pulverising: pulverizing
quantisation: quantization
quantise: quantize
quantised: quantized
quantiser: quantizer
quantisers: quantizers
quantises: quantizes
quantising: quantizing
radicalisation: radicalization
radicalise: radicalize
radicalised: radicalized
radicalises: radicalizes
radicalising: radicalizing
randomisation: randomization
randomisations: randomizations
randomise: randomize
randomised: randomized
rasterisation: rasterization
rasterisations: rasterizations
rationalisation: rationalization
rationalisations: rationalizations
rationalise: rationalize
rationalised: rationalized
rationalises: rationalizes
rationalising: rationalizing
realisation: realization
realisations: realizations
realise: realize
realised: realized
realises: realizes
realising: realizing
reauthorisation: reauthorization
reauthorise: reauthorize
reauthorised: reauthorized
reauthorises: reauthorizes
reauthorising: reauthorizing
recapitalisation: recapitalization
recapitalise: recapitalize
recapitalised: recapitalized
recapitalises: recapitalizes
recapitalising: recapitalizing
recognisable: recognizable
recognise: recognize
recognised: recognized
recognises: recognizes
recognising: recognizing
regularisation: regularization
regularisations: regularizations
regularise: regularize
regularised: regularized
regulariser: regularizer
regularisers: regularizers
regularises: regularizes
regularising: regularizing
reinitialise: reinitialize
reinitialised: reinitialized
reinitialises: reinitializes
reinitialising: reinitializing
relativise: relativize
relativised: relativized
relativises: relativizes
relativising: relativizing
renormalisable: renormalizable
renormalisation: renormalization
renormalise: renormalize
renormalised: renormalized
renormalises: renormalizes
renormalising: renormalizing
reorganisation: reorganization
reorganisations: reorganizations
reorganise: reorganize
reorganised: reorganized
reorganises: reorganizes
reorganising: reorganizing
reparameterisation: reparameterization
reparameterised: reparameterized
reserialisation: reserialization
reserialisations: reserializations
reserialise: reserialize
reserialised: reserialized
reserialises: reserializes
reserialising: reserializing
resynchronisation: resynchronization
resynchronisations: resynchronizations
resynchronise: resynchronize
resynchronised: resynchronized
resynchronises: resynchronizes
resynchronising: resynchronizing
revitalisation: revitalization
revitalise: revitalize
revitalised: revitalized
revitalises: revitalizes
revitalising: revitalizing
revolutionise: revolutionize
revolutionised: revolutionized
revolutionises: revolutionizes
revolutionising: revolutionizing
rigour: rigor
rigours: rigors
romanticise: romanticize
romanticised: romanticized
romanticises: romanticizes
romanticising: romanticizing
rumour: rumor
rumoured: rumored
rumours: rumors
sanitisation: sanitization
sanitisations: sanitizations
sanitise: sanitize
sanitised: sanitized
sanitiser: sanitizer
sanitisers: sanitizers
sanitises: sanitizes
sanitising: sanitizing
satirise: satirize
satirised: satirized
satirises: satirizes
satirising: satirizing
saviour: savior
saviours: saviors
savour: savor
savoured: savored
savouring: savoring
savours: savors
savoury: savory
scandalise: scandalize
scandalised: scandalized
scandalises: scandalizes
scandalising: scandalizing
schematise: schematize
schematised: schematized
schematises: schematizes
schematising: schematizing
scrutinise: scrutinize
scrutinised: scrutinized
scrutinises: scrutinizes
scrutinising: scrutinizing
sensationalise: sensationalize
sensationalised: sensationalized
sensationalises: sensationalizes
sensationalising: sensationalizing
sensitise: sensitize
sensitised: sensitized
sensitises: sensitizes
sensitising: sensitizing
sepulchre: sepulcher
sepulchres: sepulchers
serialisability: serializability
serialisable: serializable
serialisation: serialization
serialisations: serializations
serialise: serialize
serialised: serialized
serialiser: serializer
serialisers: serializers
serialises: serializes
serialising: serializing
sexualise: sexualize
sexualised: sexualized
sexualises: sexualizes
sexualising: sexualizing
signalled: signaled
signaller: signaler
signallers: signalers
signalling: signaling
singularise: singularize
singularised: singularized
singularises: singularizes
singularising: singularizing
skilful: skillful
skilfully: skillfully
socialisation: socialization
socialise: socialize
socialised: socialized
socialises: socializes
socialising: socializing
specialisation: specialization
specialisations: specializations
specialise: specialize
specialised: specialized
specialises: specializes
specialising: specializing
specialities: specialties
speciality: specialty
spectre: specter
spiralled: spiraled
spiralling: spiraling
splendour: splendor
splendours: splendors
stabilisation: stabilization
stabilisations: stabilizations
stabilise: stabilize
stabilised: stabilized
stabiliser: stabilizer
stabilisers: stabilizers
stabilises: stabilizes
stabilising: stabilizing
standardisation: standardization
standardisations: standardizations
standardise: standardize
standardised: standardized
standardiser: standardizer
standardisers: standardizers
standardises: standardizes
standardising: standardizing
stencilled: stenciled
stencilling: stenciling
sterilisation: sterilization
sterilise: sterilize
sterilised: sterilized
steriliser: sterilizer
sterilisers: sterilizers
sterilises: sterilizes
sterilising: sterilizing
stigmatisation: stigmatization
stigmatise: stigmatize
stigmatised: stigmatized
stigmatises: stigmatizes
stigmatising: stigmatizing
storey: story
storeys: stories
strategise: strategize
strategised: strategized
strategises: strategizes
strategising: strategizing
stylisation: stylization
stylisations: stylizations
stylise: stylize
stylised: stylized
stylises: stylizes
stylising: stylizing
subsidisation: subsidization
subsidise: subsidize
subsidised: subsidized
subsidises: subsidizes
subsidising: subsidizing
succour: succor
sulphur: sulfur
summarisation: summarization
summarisations: summarizations
summarise: summarize
summarised: summarized
summarises: summarizes
summarising: summarizing
symbolise: symbolize
symbolised: symbolized
symbolises: symbolizes
symbolising: symbolizing
sympathise: sympathize
sympathised: sympathized
sympathiser: sympathizer
sympathisers: sympathizers
sympathises: sympathizes
sympathising: sympathizing
synchronisation: synchronization
synchronisations: synchronizations
synchronise: synchronize
synchronised: synchronized
synchroniser: synchronizer
synchronisers: synchronizers
synchronises: synchronizes
synchronising: synchronizing
synthesise: synthesize
synthesised: synthesized
synthesises: synthesizes
synthesising: synthesizing
systematisation: systematization
systematise: systematize
systematised: systematized
systematises: systematizes
systematising: systematizing
tantalise: tantalize
tantalised: tantalized
tantalises: tantalizes
tantalising: tantalizing
tantalisingly: tantalizingly
terrorise: terrorize
terrorised: terrorized
terrorises: terrorizes
terrorising: terrorizing
theorise: theorize
theorised: theorized
theorises: theorizes
theorising: theorizing
titbit: tidbit
titbits: tidbits
tokenisation: tokenization
tokenise: tokenize
tokenised: tokenized
tokenises: tokenizes
tokenising: tokenizing
totalled: totaled
totalling: totaling
travelled: traveled
traveller: traveler
travellers: travelers
travelling: traveling
trivialisation: trivialization
trivialise: trivialize
trivialised: trivialized
trivialises: trivializes
trivialising: trivializing
tumour: tumor
tumours: tumors
tunnelled: tunneled
tunnelling: tunneling
unauthorised: unauthorized
unfavourable: unfavorable
uninitialise: uninitialize
uninitialised: uninitialized
uninitialises: uninitializes
uninitialising: uninitializing
unionisation: unionization
unionise: unionize
unionised: unionized
unionises: unionizes
unionising: unionizing
unmanoeuvrable: unmaneuverable
unmarshalled: unmarshaled
unmarshalling: unmarshaling
unrecognised: unrecognized
unsignalled: unsignaled
unsynchronise: unsynchronize
unsynchronised: unsynchronized
unsynchronises: unsynchronizes
unsynchronising: unsynchronizing
utilisation: utilization
utilise: utilize
utilised: utilized
utilises: utilizes
utilising: utilizing
vandalise: vandalize
vandalised: vandalized
vandalises: vandalizes
vandalising: vandalizing
vaporisation: vaporization
vaporise: vaporize
vaporised: vaporized
vaporiser: vaporizer
vaporises: vaporizes
vaporising: vaporizing
verbalise: verbalize
verbalised: verbalized
verbalises: verbalizes
verbalising: verbalizing
victimisation: victimization
victimise: victimize
victimised: victimized
victimises: victimizes
victimising: victimizing
vigour: vigor
vigours: vigors
virtualisation: virtualization
virtualisations: virtualizations
virtualise: virtualize
virtualised: virtualized
virtualises: virtualizes
virtualising: virtualizing
visualisation: visualization
visualisations: visualizations
visualise: visualize
visualised: visualized
visualiser: visualizer
visualisers: visualizers
visualises: visualizes
visualising: visualizing
zeroisation: zeroization
