absolutize: absolutise
absolutized: absolutised
absolutizes: absolutises
absolutizing: absolutising
accessorize: accessorise
accessorized: accessorised
accessorizes: accessorises
accessorizing: accessorising
acclimatization: acclimatisation
acclimatize: acclimatise
acclimatized: acclimatised
acclimatizes: acclimatises
acclimatizing: acclimatising
actualization: actualisation
actualize: actualise
actualized: actualised
actualizes: actualises
actualizing: actualising
aggrandize: aggrandise
aggrandized: aggrandised
aggrandizement: aggrandisement
aggrandizes: aggrandises
aggrandizing: aggrandising
agonize: agonise
agonized: agonised
agonizes: agonises
agonizing: agonising
agonizingly: agonisingly
airplane: aeroplane
airplanes: aeroplanes
alphabetization: alphabetisation
alphabetize: alphabetise
alphabetized: alphabetised
alphabetizes: alphabetises
alphabetizing: alphabetising
aluminum: aluminium
amortizable: amortisable
amortization: amortisation
amortize: amortise
amortized: amortised
amortizes: amortises
amortizing: amortising
analog: analogue
analogs: analogues
analyze: analyse
analyzed: analysed
analyzer: analyser
analyzers: analysers
analyzes: analyses
analyzing: analysing
anglicization: anglicisation
anglicizations: anglicisations
anglicize: anglicise
anglicized: anglicised
anglicizes: anglicises
anglicizing: anglicising
anonymization: anonymisation
anonymize: anonymise
anonymized: anonymised
anonymizer: anonymiser
anonymizers: anonymisers
anonymizes: anonymises
anonymizing: anonymising
antagonize: antagonise
antagonized: antagonised
antagonizes: antagonises
antagonizing: antagonising
anthropomorphization: anthropomorphisation
anthropomorphize: anthropomorphise
anthropomorphized: anthropomorphised
anthropomorphizes: anthropomorphises
anthropomorphizing: anthropomorphising
apologize: apologise
apologized: apologised
apologizes: apologises
apologizing: apologising
appetizer: appetiser
appetizers: appetisers
armor: armour
armored: armoured
armorer: armourer
armorers: armourers
armors: armours
armory: armoury
artifact: artefact
artifacts: artefacts
authorization: authorisation
authorizations: authorisations
authorize: authorise
authorized: authorised
authorizes: authorises
authorizing: authorising
baptize: baptise
baptized: baptised
baptizes: baptises
baptizing: baptising
behavior: behaviour
behavioral: behavioural
behaviorism: behaviourism
behaviorist: behaviourist
behaviorists: behaviourists
behaviors: behaviours
bobsled: bobsleigh
bobsleds: bobsleighs
boogeyman: bogeyman
boogeymen: bogeymen
brutalization: brutalisation
brutalize: brutalise
brutalized: brutalised
brutalizes: brutalises
brutalizing: brutalising
cancelable: cancellable
cancelation: cancellation
canceled: cancelled
canceling: cancelling
cannibalization: cannibalisation
cannibalize: cannibalise
cannibalized: cannibalised
cannibalizes: cannibalises
cannibalizing: cannibalising
canonicalized: canonicalised
canonization: canonisation
canonizations: canonisations
canonize: canonise
canonized: canonised
canonizes: canonises
canonizing: canonising
capitalization: capitalisation
capitalize: capitalise
capitalized: capitalised
capitalizes: capitalises
capitalizing: capitalising
categorizable: categorisable
categorization: categorisation
categorizations: categorisations
categorize: categorise
categorized: categorised
categorizes: categorises
categorizing: categorising
centennial: centenary
centennials: centenaries
center: centre
centers: centres
centiliter: centilitre
centiliters: centilitres
centimeter: centimetre
centimeters: centimetres
centralization: centralisation
centralizations: centralisations
centralize: centralise
centralized: centralised
centralizes: centralises
centralizing: centralising
cerebellums: cerebella
chamomile: camomile
characterization: characterisation
characterizations: characterisations
characterize: characterise
characterized: characterised
characterizes: characterises
characterizing: characterising
circularize: circularise
circularized: circularised
circularizes: circularises
circularizing: circularising
civilization: civilisation
civilizations: civilisations
civilize: civilise
civilized: civilised
civilizes: civilises
civilizing: civilising
clamor: clamour
clamors: clamours
cochleas: cochleae
colonization: colonisation
colonize: colonise
colonized: colonised
colonizer: coloniser
colonizers: colonisers
colonizes: colonises
colonizing: colonising
color: colour
colored: coloured
colorful: colourful
colorfully: colourfully
colorfulness: colourfulness
coloring: colouring
colorings: colourings
colorization: colourisation
colorize: colourise
colorized: colourised
colorizer: colouriser
colorizers: colourisers
colorizes: colourises
colorizing: colourising
colors: colours
commercialization: commercialisation
commercialize: commercialise
commercialized: commercialised
commercializes: commercialises
commercializing: commercialising
compartmentalization: compartmentalisation
compartmentalize: compartmentalise
compartmentalized: compartmentalised
compartmentalizes: compartmentalises
compartmentalizing: compartmentalising
computerization: computerisation
computerize: computerise
computerized: computerised
computerizes: computerises
computerizing: computerising
conceptualization: conceptualisation
conceptualizations: conceptualisations
conceptualize: conceptualise
conceptualized: conceptualised
conceptualizes: conceptualises
conceptualizing: conceptualising
contextualization: contextualisation
contextualize: contextualise
contextualized: contextualised
contextualizes: contextualises
contextualizing: contextualising
councilor: councillor
councilors: councillors
councilorship: councillorship
counseling: counselling
counselor: counsellor
counselors: counsellors
cozy: cosy
criminalize: criminalise
criminalized: criminalised
criminalizes: criminalises
criminalizing: criminalising
criticize: criticise
criticized: criticised
criticizes: criticises
criticizing: criticising
crystallization: crystallisation
crystallize: crystallise
crystallized: crystallised
crystallizes: crystallises
crystallizing: crystallising
customizable: customisable
customization: customisation
customizations: customisations
customize: customise
customized: customised
customizer: customiser
customizers: customisers
customizes: customises
customizing: customising
daemonization: daemonisation
daemonize: daemonise
daemonized: daemonised
daemonizes: daemonises
daemonizing: daemonising
decentralization: decentralisation
decentralize: decentralise
decentralized: decentralised
decentralizes: decentralises
decentralizing: decentralising
deciliter: decilitre
deciliters: decilitres
decriminalization: decriminalisation
decriminalize: decriminalise
decriminalized: decriminalised
decriminalizes: decriminalises
decriminalizing: decriminalising
defense: defence
defenses: defences
dehumanization: dehumanisation
dehumanize: dehumanise
dehumanized: dehumanised
dehumanizes: dehumanises
dehumanizing: dehumanising
deinitialize: deinitialise
deinitialized: deinitialised
deinitializes: deinitialises
deinitializing: deinitialising
demagog: demagogue
demagogs: demagogues
demarshaling: demarshalling
dematerialization: dematerialisation
dematerialize: dematerialise
dematerialized: dematerialised
dematerializes: dematerialises
dematerializing: dematerialising
demilitarization: demilitarisation
demilitarizations: demilitarisations
demilitarize: demilitarise
demilitarized: demilitarised
demilitarizes: demilitarises
demilitarizing: demilitarising
demobilization: demobilisation
demobilize: demobilise
demobilized: demobilised
demobilizes: demobilises
demobilizing: demobilising
democratization: democratisation
democratize: democratise
democratized: democratised
democratizes: democratises
democratizing: democratising
demonize: demonise
demonized: demonised
demonizes: demonises
demonizing: demonising
demoralization: demoralisation
demoralize: demoralise
demoralized: demoralised
demoralizes: demoralises
demoralizing: demoralising
denormalized: denormalised
dependent: dependant
dependents: dependants
depersonalize: depersonalise
depersonalized: depersonalised
depersonalizes: depersonalises
depersonalizing: depersonalising
deputize: deputise
deputized: deputised
deputizes: deputises
deputizing: deputising
desensitization: desensitisation
desensitize: desensitise
desensitized: desensitised
desensitizes: desensitises
desensitizing: desensitising
deserializability: deserialisability
deserializable: deserialisable
deserialization: deserialisation
deserializations: deserialisations
deserialize: deserialise
deserialized: deserialised
deserializer: deserialiser
deserializers: deserialisers
deserializes: deserialises
deserializing: deserialising
destabilization: destabilisation
destabilize: destabilise
destabilized: destabilised
destabilizes: destabilises
destabilizing: destabilising
desynchronization: desynchronisation
desynchronizations: desynchronisations
desynchronize: desynchronise
desynchronized: desynchronised
desynchronizes: desynchronises
desynchronizing: desynchronising
devirtualization: devirtualisation
devirtualize: devirtualise
devirtualized: devirtualised
devirtualizes: devirtualises
devirtualizing: devirtualising
dialed: dialled
dialing: dialling
dialog: dialogue
dialogs: dialogues
digitalization: digitalisation
digitalize: digitalise
digitalized: digitalised
digitalizes: digitalises
digitalizing: digitalising
digitization: digitisation
digitize: digitise
digitized: digitised
digitizes: digitises
digitizing: digitising
disorganization: disorganisation
disorganized: disorganised
draftsman: draughtsman
draftsmanship: draughtsmanship
draftsmen: draughtsmen
dramatization: dramatisation
dramatizations: dramatisations
dramatize: dramatise
dramatized: dramatised
dramatizes: dramatises
dramatizing: dramatising
dueled: duelled
dueling: duelling
economize: economise
economized: economised
economizes: economises
economizing: economising
editorialize: editorialise
editorialized: editorialised
editorializes: editorialises
editorializing: editorialising
empathize: empathise
empathized: empathised
empathizes: empathises
empathizing: empathising
emphasize: emphasise
emphasized: emphasised
emphasizes: emphasises
emphasizing: emphasising
emporiums: emporia
endeavor: endeavour
endeavors: endeavours
energize: energise
energized: energised
energizes: energises
energizing: energising
epilog: epilogue
epilogs: epilogues
epitomize: epitomise
epitomized: epitomised
epitomizes: epitomises
epitomizing: epitomising
equalization: equalisation
equalize: equalise
equalized: equalised
equalizer: equaliser
equalizers: equalisers
equalizes: equalises
equalizing: equalising
eulogize: eulogise
eulogized: eulogised
eulogizes: eulogises
eulogizing: eulogising
evangelization: evangelisation
evangelize: evangelise
evangelized: evangelised
evangelizes: evangelises
evangelizing: evangelising
externalize: externalise
externalized: externalised
externalizes: externalises
externalizing: externalising
familiarization: familiarisation
familiarizations: familiarisations
familiarize: familiarise
familiarized: familiarised
familiarizes: familiarises
familiarizing: familiarising
fantasize: fantasise
fantasized: fantasised
fantasizes: fantasises
fantasizing: fantasising
favor: favour
favorable: favourable
favorably: favourably
favored: favoured
favoring: favouring
favorite: favourite
favorites: favourites
favoritism: favouritism
favors: favours
fertilization: fertilisation
fertilize: fertilise
fertilized: fertilised
fertilizer: fertiliser
fertilizers: fertilisers
fertilizes: fertilises
fertilizing: fertilising
fervor: fervour
filet: fillet
filets: fillets
finalization: finalisation
finalize: finalise
finalized: finalised
finalizes: finalises
finalizing: finalising
fiscalization: fiscalisation
fiscalizations: fiscalisations
fiscalized: fiscalised
flavor: flavour
flavored: flavoured
flavoring: flavouring
flavors: flavours
flextime: flexitime
formalize: formalise
formalized: formalised
formalizes: formalises
formalizing: formalising
fraternization: fraternisation
fraternize: fraternise
fraternized: fraternised
fraternizes: fraternises
fraternizing: fraternising
fulfill: fulfil
fulfillment: fulfilment
fulfills: fulfils
galvanize: galvanise
galvanized: galvanised
galvanizes: galvanises
galvanizing: galvanising
generalization: generalisation
generalizations: generalisations
generalize: generalise
generalized: generalised
generalizes: generalises
generalizing: generalising
glamor: glamour
glamorize: glamorise
glamorized: glamorised
glamorizes: glamorises
glamorizing: glamorising
globalization: globalisation
globalize: globalise
globalized: globalised
globalizes: globalises
globalizing: globalising
gray: grey
grayed: greyed
graying: greying
grayish: greyish
graylist: greylist
graylisted: greylisted
graylisting: greylisting
graylists: greylists
grayness: greyness
grays: greys
grayscale: greyscale
groundskeeper: groundsman
groundskeepers: groundsmen
harbor: harbour
harbored: harboured
harboring: harbouring
harbors: harbours
harmonization: harmonisation
harmonizations: harmonisations
harmonize: harmonise
harmonized: harmonised
harmonizes: harmonises
harmonizing: harmonising
homogenization: homogenisation
homogenize: homogenise
homogenized: homogenised
homogenizes: homogenises
homogenizing: homogenising
honor: honour
honorable: honourable
honorables: honourables
honored: honoured
honoring: honouring
honors: honours
hospitalization: hospitalisation
hospitalizations: hospitalisations
hospitalize: hospitalise
hospitalized: hospitalised
hospitalizes: hospitalises
hospitalizing: hospitalising
humanization: humanisation
humanize: humanise
humanized: humanised
humanizes: humanises
humanizing: humanising
humor: humour
humorless: humourless
humorous: humourous
humors: humours
hybridization: hybridisation
hybridize: hybridise
hybridized: hybridised
hybridizes: hybridises
hybridizing: hybridising
hypnotize: hypnotise
hypnotized: hypnotised
hypnotizes: hypnotises
hypnotizing: hypnotising
hypothesize: hypothesise
hypothesized: hypothesised
hypothesizes: hypothesises
hypothesizing: hypothesising
idealization: idealisation
idealize: idealise
idealized: idealised
idealizes: idealises
idealizing: idealising
idolize: idolise
idolized: idolised
idolizes: idolises
idolizing: idolising
immobilization: immobilisation
immobilize: immobilise
immobilized: immobilised
immobilizer: immobiliser
immobilizers: immobilisers
immobilizes: immobilises
immobilizing: immobilising
immortalize: immortalise
immortalized: immortalised
immortalizes: immortalises
immortalizing: immortalising
immunization: immunisation
immunizations: immunisations
immunize: immunise
immunized: immunised
immunizes: immunises
immunizing: immunising
individualize: individualise
individualized: individualised
individualizes: individualises
individualizing: individualising
industrialization: industrialisation
industrialize: industrialise
industrialized: industrialised
industrializes: industrialises
industrializing: industrialising
initializable: initialisable
initialization: initialisation
initializations: initialisations
initialize: initialise
initialized: initialised
initializer: initialiser
initializers: initialisers
initializes: initialises
initializing: initialising
institutionalize: institutionalise
institutionalized: institutionalised
institutionalizes: institutionalises
institutionalizing: institutionalising
internalization: internalisation
internalize: internalise
internalized: internalised
internalizes: internalises
internalizing: internalising
internationalization: internationalisation
internationalize: internationalise
internationalized: internationalised
internationalizes: internationalises
internationalizing: internationalising
ionization: ionisation
ionize: ionise
ionized: ionised
ionizes: ionises
ionizing: ionising
italicize: italicise
italicized: italicised
italicizes: italicises
italicizing: italicising
itemize: itemise
itemized: itemised
itemizes: itemises
itemizing: itemising
jeopardize: jeopardise
jeopardized: jeopardised
jeopardizes: jeopardises
jeopardizing: jeopardising
jeweler: jeweller
jewelry: jewellery
journaling: journalling
judgment: judgement
kilometer: kilometre
kilometers: kilometres
labelable: labellable
labeled: labelled
labeler: labeller
labelers: labellers
labeling: labelling
labor: labour
labored: laboured
laboring: labouring
labors: labours
legalization: legalisation
legalize: legalise
legalized: legalised
legalizes: legalises
legalizing: legalising
legitimize: legitimise
legitimized: legitimised
legitimizes: legitimises
legitimizing: legitimising
lemmatization: lemmatisation
lemmatize: lemmatise
lemmatized: lemmatised
lemmatizes: lemmatises
lemmatizing: lemmatising
leveled: levelled
leveling: levelling
liberalize: liberalise
liberalized: liberalised
liberalizes: liberalises
liberalizing: liberalising
license: licence
licenses: licences
linearization: linearisation
linearizations: linearisations
linearize: linearise
linearized: linearised
linearizes: linearises
linearizing: linearising
liter: litre
liters: litres
localization: localisation
localizations: localisations
localize: localise
localized: localised
localizer: localiser
localizers: localisers
localizes: localises
localizing: localising
maneuver: manoeuvre
maneuverability: manoeuvrability
maneuverable: manoeuvrable
maneuvered: manoeuvred
maneuvering: manoeuvring
maneuvers: manoeuvres
marginalize: marginalise
marginalized: marginalised
marginalizes: marginalises
marginalizing: marginalising
marshal: marshall
marshaled: marshalled
marshaler: marshaller
marshalers: marshallers
marshaling: marshalling
marshals: marshalls
marvelous: marvellous
materialize: materialise
materialized: materialised
materializes: materialises
materializing: materialising
maximization: maximisation
maximize: maximise
maximized: maximised
maximizes: maximises
maximizing: maximising
mechanization: mechanisation
mechanize: mechanise
mechanized: mechanised
mechanizes: mechanises
mechanizing: mechanising
memorialize: memorialise
memorialized: memorialised
memorializes: memorialises
memorializing: memorialising
memorization: memorisation
memorize: memorise
memorized: memorised
memorizes: memorises
memorizing: memorising
mesmerize: mesmerise
mesmerized: mesmerised
mesmerizes: mesmerises
mesmerizing: mesmerising
metabolize: metabolise
metabolized: metabolised
metabolizes: metabolises
metabolizing: metabolising
metastasize: metastasise
metastasized: metastasised
metastasizes: metastasises
metastasizing: metastasising
meter: metre
meters: metres
micrometer: micrometre
micrometers: micrometres
militarized: militarised
milliliter: millilitre
milliliters: millilitres
millimeter: millimetre
millimeters: millimetres
minimization: minimisation
minimize: minimise
minimized: minimised
minimizes: minimises
minimizing: minimising
mischaracterization: mischaracterisation
mischaracterize: mischaracterise
mischaracterized: mischaracterised
mischaracterizes: mischaracterises
mischaracterizing: mischaracterising
miter: mitre
miters: mitres
mobilization: mobilisation
mobilizations: mobilisations
mobilize: mobilise
mobilized: mobilised
mobilizes: mobilises
mobilizing: mobilising
modeled: modelled
modeling: modelling
modernization: modernisation
modernizations: modernisations
modernize: modernise
modernized: modernised
modernizes: modernises
modernizing: modernising
modularization: modularisation
modularize: modularise
modularized: modularised
modularizes: modularises
modularizing: modularising
moisturize: moisturise
moisturized: moisturised
moisturizer: moisturiser
moisturizers: moisturisers
moisturizes: moisturises
moisturizing: moisturising
mold: mould
molded: moulded
molder: moulder
moldered: mouldered
moldering: mouldering
molders: moulders
molding: moulding
moldings: mouldings
molds: moulds
monolog: monologue
monologs: monologues
monopolization: monopolisation
monopolize: monopolise
monopolized: monopolised
monopolizes: monopolises
monopolizing: monopolising
moralize: moralise
moralized: moralised
moralizes: moralises
moralizing: moralising
mutualization: mutualisation
mutualize: mutualise
mutualized: mutualised
mutualizes: mutualises
mutualizing: mutualising
nanometer: nanometre
nanometers: nanometres
nasalization: nasalisation
nasalizations: nasalisations
nasalize: nasalise
nasalized: nasalised
nasalizes: nasalises
nasalizing: nasalising
nationalization: nationalisation
nationalize: nationalise
nationalized: nationalised
nationalizes: nationalises
nationalizing: nationalising
naturalization: naturalisation
naturalize: naturalise
naturalized: naturalised
naturalizes: naturalises
naturalizing: naturalising
neighbor: neighbour
neighbored: neighboured
neighborhood: neighbourhood
neighborhoods: neighbourhoods
neighboring: neighbouring
neighbors: neighbours
neutralization: neutralisation
neutralize: neutralise
neutralized: neutralised
neutralizes: neutralises
neutralizing: neutralising
normalizable: normalisable
normalization: normalisation
normalizations: normalisations
normalize: normalise
normalized: normalised
normalizer: normaliser
normalizers: normalisers
normalizes: normalises
normalizing: normalising
odometer: odometre
odometers: odometres
odor: odour
odors: odours
optimization: optimisation
optimizations: optimisations
optimize: optimise
optimized: optimised
optimizer: optimiser
optimizers: optimisers
optimizes: optimises
optimizing: optimising
organization: organisation
organizational: organisational
organizations: organisations
organize: organise
organized: organised
organizer: organiser
organizers: organisers
organizes: organises
organizing: organising
ostracize: ostracise
ostracized: ostracised
ostracizes: ostracises
ostracizing: ostracising
overemphasize: overemphasise
overemphasized: overemphasised
overemphasizes: overemphasises
overemphasizing: overemphasising
oxidization: oxidisation
oxidize: oxidise
oxidized: oxidised
oxidizes: oxidises
oxidizing: oxidising
packetize: packetise
packetized: packetised
packetizes: packetises
packetizing: packetising
palatalization: palatalisation
palatalize: palatalise
palatalized: palatalised
palatalizes: palatalises
palatalizing: palatalising
paleolithic: palaeolithic
palletize: palletise
palletized: palletised
palletizes: palletises
palletizing: palletising
parallelization: parallelisation
parallelizations: parallelisations
parallelize: parallelise
parallelized: parallelised
parallelizes: parallelises
parallelizing: parallelising
paralyze: paralyse
paralyzed: paralysed
paralyzes: paralyses
paralyzing: paralysing
parameterizable: parameterisable
parameterization: parameterisation
parameterizations: parameterisations
parameterize: parameterise
parameterized: parameterised
parameterizes: parameterises
parameterizing: parameterising
parametrization: parametrisation
parametrizations: parametrisations
parametrize: parametrise
parametrized: parametrised
parametrizes: parametrises
parametrizing: parametrising
paravirtualization: paravirtualisation
paravirtualize: paravirtualise
paravirtualized: paravirtualised
paravirtualizes: paravirtualises
paravirtualizing: paravirtualising
parenthesize: parenthesise
parenthesized: parenthesised
parenthesizes: parenthesises
parenthesizing: parenthesising
parlor: parlour
parlors: parlours
patronize: patronise
patronized: patronised
patronizes: patronises
patronizing: patronising
penalize: penalise
penalized: penalised
penalizes: penalises
penalizing: penalising
personalization: personalisation
personalize: personalise
personalized: personalised
personalizes: personalises
personalizing: personalising
plagiarize: plagiarise
plagiarized: plagiarised
plagiarizes: plagiarises
plagiarizing: plagiarising
plow: plough
plowed: ploughed
plowing: ploughing
plowman: ploughman
plowmen: ploughmen
plows: ploughs
plowshare: ploughshare
plowshares: ploughshares
pluralization: pluralisation
pluralize: pluralise
pluralized: pluralised
pluralizes: pluralises
pluralizing: pluralising
polarization: polarisation
polarize: polarise
polarized: polarised
polarizer: polariser
polarizers: polarisers
polarizes: polarises
polarizing: polarising
politicize: politicise
politicized: politicised
politicizes: politicises
politicizing: politicising
popularization: popularisation
popularizations: popularisations
popularize: popularise
popularized: popularised
popularizes: popularises
popularizing: popularising
preauthorization: preauthorisation
preauthorizations: preauthorisations
preauthorize: preauthorise
preauthorized: preauthorised
preauthorizes: preauthorises
preauthorizing: preauthorising
pressurization: pressurisation
pressurize: pressurise
pressurized: pressurised
pressurizes: pressurises
pressurizing: pressurising
prioritization: prioritisation
prioritize: prioritise
prioritized: prioritised
prioritizes: prioritises
prioritizing: prioritising
privatization: privatisation
privatizations: privatisations
privatize: privatise
privatized: privatised
privatizes: privatises
privatizing: privatising
professionalize: professionalise
professionalized: professionalised
professionalizes: professionalises
professionalizing: professionalising
propagandize: propagandise
propagandized: propagandised
propagandizes: propagandises
propagandizing: propagandising
proselytize: proselytise
proselytized: proselytised
proselytizer: proselytiser
proselytizers: proselytisers
proselytizes: proselytises
proselytizing: proselytising
publicize: publicise
publicized: publicised
publicizes: publicises
publicizing: publicising
pulverize: pulverise
pulverized: pulverised
pulverizes: pulverises
pulverizing: pulverising
quantization: quantisation
quantize: quantise
quantized: quantised
quantizer: quantiser
quantizers: quantisers
quantizes: quantises
quantizing: quantising
radicalization: radicalisation
radicalize: radicalise
radicalized: radicalised
radicalizes: radicalises
radicalizing: radicalising
randomization: randomisation
randomizations: randomisations
randomize: randomise
randomized: randomised
rasterization: rasterisation
rasterizations: rasterisations
rationalization: rationalisation
rationalizations: rationalisations
rationalize: rationalise
rationalized: rationalised
rationalizes: rationalises
rationalizing: rationalising
realization: realisation
realizations: realisations
realize: realise
realized: realised
realizes: realises
realizing: realising
reauthorization: reauthorisation
reauthorize: reauthorise
reauthorized: reauthorised
reauthorizes: reauthorises
reauthorizing: reauthorising
recapitalization: recapitalisation
recapitalize: recapitalise
recapitalized: recapitalised
recapitalizes: recapitalises
recapitalizing: recapitalising
recognizable: recognisable
recognize: recognise
recognized: recognised
recognizes: recognises
recognizing: recognising
regularization: regularisation
regularizations: regularisations
regularize: regularise
regularized: regularised
regularizer: regulariser
regularizers: regularisers
regularizes: regularises
regularizing: regularising
reinitialize: reinitialise
reinitialized: reinitialised
reinitializes: reinitialises
reinitializing: reinitialising
relativize: relativise
relativized: relativised
relativizes: relativises
relativizing: relativising
renormalizable: renormalisable
renormalization: renormalisation
renormalize: renormalise
renormalized: renormalised
renormalizes: renormalises
renormalizing: renormalising
reorganization: reorganisation
reorganizations: reorganisations
reorganize: reorganise
reorganized: reorganised
reorganizes: reorganises
reorganizing: reorganising
reparameterization: reparameterisation
reparameterized: reparameterised
reserialization: reserialisation
reserializations: reserialisations
reserialize: reserialise
reserialized: reserialised
reserializes: reserialises
reserializing: reserialising
resynchronization: resynchronisation
resynchronizations: resynchronisations
resynchronize: resynchronise
resynchronized: resynchronised
resynchronizes: resynchronises
resynchronizing: resynchronising
revitalization: revitalisation
revitalize: revitalise
revitalized: revitalised
revitalizes: revitalises
revitalizing: revitalising
revolutionize: revolutionise
revolutionized: revolutionised
revolutionizes: revolutionises
revolutionizing: revolutionising
rigamarole: rigmarole
rigor: rigour
rigors: rigours
romanticize: romanticise
romanticized: romanticised
romanticizes: romanticises
romanticizing: romanticising
rumor: rumour
rumored: rumoured
rumors: rumours
sanitization: sanitisation
sanitizations: sanitisations
sanitize: sanitise
sanitized: sanitised
sanitizer: sanitiser
sanitizers: sanitisers
sanitizes: sanitises
sanitizing: sanitising
satirize: satirise
satirized: satirised
satirizes: satirises
satirizing: satirising
savior: saviour
saviors: saviours
savor: savour
savored: savoured
savoring: savouring
savors: savours
savory: savoury
scandalize: scandalise
scandalized: scandalised
scandalizes: scandalises
scandalizing: scandalising
schematize: schematise
schematized: schematised
schematizes: schematises
schematizing: schematising
scrutinize: scrutinise
scrutinized: scrutinised
scrutinizes: scrutinises
scrutinizing: scrutinising
sensationalize: sensationalise
sensationalized: sensationalised
sensationalizes: sensationalises
sensationalizing: sensationalising
sensitize: sensitise
sensitized: sensitised
sensitizes: sensitises
sensitizing: sensitising
sepulcher: sepulchre
sepulchers: sepulchres
serializability: serialisability
serializable: serialisable
serialization: serialisation
serializations: serialisations
serialize: serialise
serialized: serialised
serializer: serialiser
serializers: serialisers
serializes: serialises
serializing: serialising
sexualize: sexualise
sexualized: sexualised
sexualizes: sexualises
sexualizing: sexualising
signaled: signalled
signaler: signaller
signalers: signallers
signaling: signalling
singularize: singularise
singularized: singularised
singularizes: singularises
singularizing: singularising
skillful: skilful
skillfully: skilfully
sled: sledge
sleds: sledges
socialization: socialisation
socialize: socialise
socialized: socialised
socializes: socialises
socializing: socialising
specialization: specialisation
specializations: specialisations
specialize: specialise
specialized: specialised
specializes: specialises
specializing: specialising
specialties: specialities
specialty: speciality
specter: spectre
spiraled: spiralled
spiraling: spiralling
splendor: splendour
splendors: splendours
stabilization: stabilisation
stabilizations: stabilisations
stabilize: stabilise
stabilized: stabilised
stabilizer: stabiliser
stabilizers: stabilisers
stabilizes: stabilises
stabilizing: stabilising
standardization: standardisation
standardizations: standardisations
standardize: standardise
standardized: standardised
standardizer: standardiser
standardizers: standardisers
standardizes: standardises
standardizing: standardising
stenciled: stencilled
stenciling: stencilling
sterilization: sterilisation
sterilize: sterilise
sterilized: sterilised
sterilizer: steriliser
sterilizers: sterilisers
sterilizes: sterilises
sterilizing: sterilising
stigmatization: stigmatisation
stigmatize: stigmatise
stigmatized: stigmatised
stigmatizes: stigmatises
stigmatizing: stigmatising
strategize: strategise
strategized: strategised
strategizes: strategises
strategizing: strategising
stylization: stylisation
stylizations: stylisations
stylize: stylise
stylized: stylised
stylizes: stylises
stylizing: stylising
subsidization: subsidisation
subsidize: subsidise
subsidized: subsidised
subsidizes: subsidises
subsidizing: subsidising
succor: succour
sulfur: sulphur
summarization: summarisation
summarizations: summarisations
summarize: summarise
summarized: summarised
summarizes: summarises
summarizing: summarising
symbolize: symbolise
symbolized: symbolised
symbolizes: symbolises
symbolizing: symbolising
sympathize: sympathise
sympathized: sympathised
sympathizer: sympathiser
sympathizers: sympathisers
sympathizes: sympathises
sympathizing: sympathising
synchronization: synchronisation
synchronizations: synchronisations
synchronize: synchronise
synchronized: synchronised
synchronizer: synchroniser
synchronizers: synchronisers
synchronizes: synchronises
synchronizing: synchronising
synthesize: synthesise
synthesized: synthesised
synthesizes: synthesises
synthesizing: synthesising
systematization: systematisation
systematize: systematise
systematized: systematised
systematizes: systematises
systematizing: systematising
tantalize: tantalise
tantalized: tantalised
tantalizes: tantalises
tantalizing: tantalising
tantalizingly: tantalisingly
terrorize: terrorise
terrorized: terrorised
terrorizes: terrorises
terrorizing: terrorising
theorize: theorise
theorized: theorised
theorizes: theorises
theorizing: theorising
tidbit: titbit
tidbits: titbits
tokenization: tokenisation
tokenize: tokenise
tokenized: tokenised
tokenizes: tokenises
tokenizing: tokenising
totaled: totalled
totaling: totalling
traveled: travelled
traveler: traveller
travelers: travellers
traveling: travelling
trivialization: trivialisation
trivialize: trivialise
trivialized: trivialised
trivializes: trivialises
trivializing: trivialising
tumor: tumour
tumors: tumours
tunneled: tunnelled
tunneling: tunnelling
unauthorized: unauthorised
unfavorable: unfavourable
uninitialize: uninitialise
uninitialized: uninitialised
uninitializes: uninitialises
uninitializing: uninitialising
unionization: unionisation
unionize: unionise
unionized: unionised
unionizes: unionises
unionizing: unionising
unmaneuverable: unmanoeuvrable
unmarshaled: unmarshalled
unmarshaling: unmarshalling
unrecognized: unrecognised
unsignaled: unsignalled
unsynchronize: unsynchronise
unsynchronized: unsynchronised
unsynchronizes: unsynchronises
unsynchronizing: unsynchronising
utilization: utilisation
utilize: utilise
utilized: utilised
utilizes: utilises
utilizing: utilising
vandalize: vandalise
vandalized: vandalised
vandalizes: vandalises
vandalizing: vandalising
vaporization: vaporisation
vaporize: vaporise
vaporized: vaporised
vaporizer: vaporiser
vaporizes: vaporises
vaporizing: vaporising
verbalize: verbalise
verbalized: verbalised
verbalizes: verbalises
verbalizing: verbalising
victimization: victimisation
victimize: victimise
victimized: victimised
victimizes: victimises
victimizing: victimising
vigor: vigour
vigors: vigours
virtualization: virtualisation
virtualizations: virtualisations
virtualize: virtualise
virtualized: virtualised
virtualizes: virtualises
virtualizing: virtualising
visualization: visualisation
visualizations: visualisations
visualize: visualise
visualized: visualised
visualizer: visualiser
visualizers: visualisers
visualizes: visualises
visualizing: visualising
zeroization: zeroisation
