analogus: analogue
analogus: analogues
authorixed: authorised
cancalled: cancelled
colourfull: colourful
crystalisation: crystallisation
draughtman: draughtsman
draughtmanship: draughtsmanship
draughtmen: draughtsmen
epiloque: epilogue
fullfil: fulfil
initailiser: initialiser
initailisers: initialisers
initaliser: initialiser
initalisers: initialisers
initiailses: initialises
intialise: initialise
intialised: initialised
jewelery: jewellery
lisence: licence
maneouvre: manoeuvre
maneouvred: manoeuvred
maneouvres: manoeuvres
maneouvring: manoeuvring
manoeuverability: manoeuvrability
manoeuvering: manoeuvring
mispelt: misspelt
monetize: monetise
monetized: monetised
monetizes: monetises
monetizing: monetising
neigbourhood: neighbourhood
optimsation: optimisation
optimsed: optimised
parenthised: parenthesised
serialier: serialiser
serilisation: serialisation
serilisation: sterilisation
serilise: serialise
serilise: sterilise
serilised: serialised
serilised: sterilised
skilfull: skilful
specialied: specialised
syncronisation: synchronisation
synthezised: synthesised
uninitialied: uninitialised
unintialised: uninitialised
